LibraryMainServicesTitle =مدخل خدمات المكتبة
LibraryTimingTitle =المقدمة
LIBRARY_TIMING_TEXT =مواعيد المكتبة
NewArrivalBookTitle =الكتب التي وصلت حديثا
BorrowedBooksTitle =عدد الكتب المستعارة
OverDueBookTitle = الكتب المتأخرة
FirstName = الاول
FamilyName = العائلة
LibraryName =المكتبة
Day =اليوم
LibraryOpeningTime =مواعيد العمل
LibraryClosingTime =إغلاق
MainLibrary =المكتبة الرئيسية
MedicineLibrary =المكتبة الطبية
CommerceLibrary =مكتبة التجارة
ErrorMsgNoRecordeFound =لم يتم استعارة اي كتاب
BookTitle  =اسم الكتاب
BookOutDate =تاريخ الاستعارة
BookReturnDate =تاريخ الارجاع
ArrivalBookDate =تاريخ الوصول
OverdueBook = متأخر 
BookDetail =تفاصيل الكتاب
DisplayCustomizedArrivalBookDate =الرجاء تعديل تاريخ إظهار الكتب الحديثة:
CustomizedArrivalBookDate=إظهار الكتب الحديثة التي وصلت
CustomizedArrivalBookDateToday =اليوم
CustomizedArrivalBookDateBeforeOneDay =قبل يوم واحد
CustomizedArrivalBookDateBeforeThreeDays =قبل ثلاثة ايام
CustomizedArrivalBookDateBeforeWeek =قبل اسبوع
CustomizedArrivalBookDateBeforeMonth =قبل شهر
CustomizedArrivalBookDateBeforeFiveMonths =قبل خمسة اشهر
OverDueDays =عدد ايام التأخير
OverDueBookError =لا توجد كتب متأخرة
ErrorMsgNoEmpNo = لم يتم ربط رقم الموظف مع اسم مستخدم الانترنت ، الرجاء مراجعة مركز نظم المعلومات
ErrorMsg =  خطأ في اتمام العملية المطلوبة : 